25.XS
......X....XXXXXX...XX..X
XX..X.X...XX.....XXXXXX..
XX...XXX..X.X.X......XXX.
X..X..XXX.X...X.XX...XXX.
.X..XX..X...X....XX.XXX.X
....X...X.....X..X.XX..X.
X.X.XXXX..X.X...X.....X..
.XX.XX.XX...X..X.XX.X...X
......XX....X.XX.........
..XXXXX.X.........X..X.X.
XX.....XXX.....XX.X...XX.
...XXX.X..X.X.XX.X.X....X
..XX.....XX..X...XX.XX.X.
....X..X.X.XX.X....XX.X.X
.XXX.X.........X.XXXXXX..
.X...XXX..XXXX.X..X.X.X.X
X...X...X..XX.XXX.X.....X
.X.XX.....X....X.XX.X..X.
X.X.....XXX....X.XX.XX...
.X...X.XXX.X..X....X.XX..
..X..XX..XX.X.X..X...X.X.
.XX..X...X....XX.X.XXXX..
.XX...X.X........XX......
...X......X..XX...X.....X
XX.XXXX.XXX...X..XX.X....